0,0,0,0,0,0,0,0,0,0,0,0,0,0,0,0
0,0,0,0,0,0,0,0,0,0,0,0,0,0,0,0
0,0,7,7,7,7,7,0,0,7,7,7,7,7,0,0
0,0,7,0,9,0,7,0,0,7,0,9,0,7,0,0
0,0,7,0,0,0,7,0,0,7,0,0,0,7,0,0
0,0,7,0,12,0,7,0,0,7,0,12,0,7,0,0
0,0,7,0,0,0,7,0,0,7,0,0,0,7,0,0
0,0,0,0,0,0,0,0,0,0,0,0,0,0,0,0
0,0,0,0,0,0,0,0,0,0,0,0,0,0,0,0
0,0,7,0,0,0,7,0,0,7,0,0,0,7,0,0
0,0,7,0,12,0,7,0,0,7,0,12,0,7,0,0
0,0,7,0,0,0,7,0,0,7,0,0,0,7,0,0
0,0,7,0,9,0,7,0,0,7,0,9,0,7,0,0
0,0,7,7,7,7,7,0,0,7,7,7,7,7,0,0
0,0,0,0,0,0,0,0,0,0,0,0,0,0,0,0
0,0,0,0,0,0,0,0,0,0,0,0,0,0,0,0
